ab (a) + abl.	de (éloignement ou origine); de, par (agent du passif); depuis
abdere, o, didi, ditum	cacher/écarter
abducere, o, duxi, ductum	emmener; détourner (de: ab + abl.)
abesse, sum, afui	être absent; être éloigné (de: génér. ab + abl.)
abire, eo, ii, itum	partir/s'en aller; quitter, s'éloigner de (ab ou ex + abl.)
abjicere, io, jeci, jectum	rejeter; abaisser
abnuere, o, nui	faire signe que non; refuser; nier
abscondere, o, didi (di), ditum (absconsum)	cacher
absens, entis	absent
absolvere, o, solvi, solutum	acquitter/dégager; achever
abstinere, eo, tinui, tentum	tenir éloigné de; s'abstenir de (+ abl. avec ou sans ab)
ac (atque)	et
accedere, o, cessi, cessum	s'approcher de; s'ajouter (ad hoc)
accedit, cessit	à cela s'ajoute le fait que (quod + ind. ou ut/ut non + subj.)
accendere, o, di, sum	allumer, enflammer
accidere, o, cidi	arriver (par hasard), survenir
accidit, cidit	il arrive que (ut/ut non + subj.)/qqf., il arrive par malheur que
accipere, io, cepi, ceptum	recevoir (de: ab + abl.); apprendre que (+ prop. inf.)/subir
accire, io, i(v)i, itum	faire venir, mander
accumbere, o, cubui, cubitum	s'étendre (sur un lit de table), se mettre à table
accurate	avec soin
accusare, o, rég.	accuser
acer, acris, acre	perçant; vif; violent/impétueux
acerbus, a, um	âpre; cruel; prématuré/aigre
acies, aciei, f.	la pointe; le tranchant; la ligne de bataille; la pénétration (de l'esprit ou des yeux)/le regard
acquirere, o, quisivi, situm	acquérir
actio, onis, f.	l'activité; la poursuite judiciaire; le plaidoyer
actus, us, m.	le mouvement; le jeu d'un acteur; l'acte (d'une pièce de théâtre); l'action (sens post.)
acutus, a, um	aigu; pénétrant/fin (esprit)
ad + acc.	vers, près de; jusqu'à; en vue de, pour
addere, o, didi, ditum	ajouter/appliquer à
adducere, o, duxi, ductum	amener
adeo	à tel point, tant
adesse, sum, adfui	être présent; assister (+ dat.)/être près de (+ dat.)
adhibere, eo, ui, itum	employer, appliquer/faire venir; admettre (qqn)
adhuc	jusqu'à présent, encore
adigere, o, egi, actum	pousser vers; contraindre à
adimere, o, emi, emptum	enlever, ôter
adipisci, or, adeptus sum (déponnent)	atteindre; obtenir
adire, eo, ii, itum	aller vers; aller trouver (qqn: + acc.)/aborder
aditus, us, m.	l'accès, l'abord
adjicere, io, jeci, jectum	jeter vers; ajouter
adjumentutum, i, n.	l'aide
adjungere, o, junxi, junctum	ajouter
adjuvare, o, juvi, jutum	aider
administrare, o, rég.	diriger, administrer/s'occuper de (+ acc.)
admirari, or, rég. (déponnent)	s'étonner de (+ acc.); admirer
admiratio, onis, f.	l'étonnement; l'admiration
admittere, o, misi, missum	laisser venir; admettre/laisser aller
scelus admittere	commettre un crime
admodum	tout à fait, pleinement
admonere, eo, ui, itum	avertir (que: + prop. inf.); engager à (faire qqch.: ut/ne + subj.)
admovere, eo, movi, motum	approcher (qqch.) de, appliquer à (+ dat. ou ad + acc.)
adolescere, o, adolevi, adultum	grandir
adoriri, ior, ortus sum (déponnent)	attaquer; entreprendre
adulatio, onis, f.	la basse flatterie; l'adulation
adulescens, entis, m. et f.	le jeune homme, la jeune femme
adulescentia, ae, f.	la jeunesse
advenire, io, veni, ventum	arriver
adventus, us, m.	l'arrivée
adversarius, a, um	adverse, opposé
adversarius, ii, m.	l'adversaire
adversum/adversus + acc.	en face de; envers; contre
adversus, a, um	placé en face; défavorable/opposé; hostile
advertere, o, ti, sum	tourner vers
(animum) advertere = animadvertere	faire attention à, remarquer
aedes, is, f.	le temple
aedes, ium, f. pl.	les temples; la maison
aedificare, o, rég.	bâtir
aedificium, ii, n.	le bâtiment; la ferme
aedilis, is, m.	l'édile
aedilitas, atis, f.	l'édilité
aeger, gra, grum	malade
aegre	avec peine
aemulus, a, um	rival, émule
aeneus, a, um	de bronze
aequalis, is, e	du même âge; égal
aequare, o, rég.	égaler/égaliser
aeque	également, de la même manière, autant; équitablement
aequitas, atis, f.	l'égalité d'âme, le calme; l'équité
aequo animo	avec calme; avec sérénité/avec résignation
aequor, oris, n. (poétique)	la plaine; la mer
aequus, a, um	égal; plat; calme; juste/équitable; favorable
aer, aeris, m.	l'air
aerarium, ii, n.	le trésor public
aes, aeris, n.	le bronze; l'argent (monnaie)/la fortune
aes alienum, aeris alieni, n.	la dette
aestas, atis, f.	l'été
aestimare, o, rég.	évaluer, apprécier
aestus, us, m.	la grande chaleur; le bouillonnement; la marée
aetas, atis, f.	la vie; l'âge; l'époque
aeternus, a, um	éternel
aether, eris, m. (poétique)	l'éther (air subtil au-dessus de l'atmosphère); le ciel, l'air
aevum, i, n. (poétique)	la vie; l'époque/la durée illimitée, le temps
affectus (adfectus), us, m.	l'état physique, la maladie; l'état d'âme, le sentiment, la passion
affere (adferre), fero, attuli, allatum	apporter
afficere (adficere), io, feci, fectum	mettre dans tel ou tel état; affaiblir
affirmare, o, rég.	affermir; affirmer
affligere (adfligere), o, flixi, flictum	abattre
agellus, i, m.	le petit champ
ager, agri, m.	le champ; le territoire
agere, o, egi, actum	faire; agir; pousser devant soi/s'occuper de (+ acc.)
agere causam	plaider une cause
agere gratias	adresser des remerciements, remercier (+ dat.)
agere tempus	passer son temps
agere vitam	passer sa vie
agger, eris, m.	le remblai
aggredi (adgredi), ior, gressus sum (déponnent)	attaquer; entreprendre/aborder
aggregare, o, rég.	adjoindre, réunir
agitare, o, rég.	exciter; passer son temps à (+ acc.); méditer/poursuivre; discuter (qqch.)
agmen, minis, n.	l'armée en marche, la colonne/la file; la marche (d'une troupe)
novissimum agmen	l'arrière-garde
agnoscere, o, agnovi, agnitum	reconnaître
agrestis, is, e	champêtre; grossier
agricola, ae, m.	le paysan/le cultivateur
aheneus, a, um	de bronze
ait, aio, aiunt	dire; affirmer
ala, ae, f.	l'aile (d'oiseau ou d'armée)/le corps de cavalerie alliée
alacer, cris, cre	plein d'entrain, joyeux
albus, a, um	blanc
alere, o, alui, al(i)tum	nourrir, entretenir
alia	par ailleurs (lieu)
alias	en une autre circonstance
alibi	ailleurs (sans changement de lieu)
alienus, a, um	d'autrui; étranger; hostile (à: ab + abl.)/défavorable
alii, ae, a	d'autres/qqf. les autres
alii... alii	les uns... les autres
alio	ailleurs (avec changement de lieu)
alioqui (alioquin)	sous d'autres rapports, du reste; autrement, sans quoi
aliquando	un jour, une fois
aliquanto	(devant les comparatifs) quelque peu; passablement
aliquantum	quelque peu; passablement
aliquis (aliqui), qua, quid (quod)	quelqu'un (d'indéterminé); quelque, un
aliquot	quelques, un certain nombre (de)
aliter	autrement
aliunde	d'ailleurs (lieu)
alius, a, ud (génitif alterius, datif alii)	un autre; autre (que: ac/atque ou quam)
alligare (adligare), o, rég.	attacher à; lier, enchaîner
alloqui, or, locutus sum (déponnent)	adresser la parole à (+ acc.)
alter, tera, terum (génitif alterius, datif alteri)	l'un des deux, l'autre (de deux), le second
alter... alter	l'un... l'autre
alteruter, tra, trum	l'un ou l'autre (de deux)
altitudo, dinis, f.	la hauteur; la profondeur
altum, i, n.	la haute mer; la profondeur
altus, a, um	haut; profond
alveus, i, m.	la cavité; l'objet creux (bateau, baignoire, etc.); le lit d'un cours d'eau
amare, o, rég.	aimer (par inclination)
ambitio, onis, f.	les démarches électorales; l'ambition/le désir de popularité
ambitus, us, m.	le détour; l'intrigue/le circuit; la brigue
ambo, ae, o (déclinaison de duo)	tous deux ensemble, les deux en même temps
ambulare, o, rég.	se promener/marcher
amens, entis	fou/qui a perdu l'esprit
amentia, ae, f.	l'égarement, la folie
amicitia, ae, f.	l'amitié
amicus, a, um	ami
amicus, i, m.	l'ami
amittere, o, misi, missum	laisser échapper, perdre
amnis, is, m.	le fleuve, le fort cours d'eau
amoenus, a, um	agréable, charmant (généralement en parlant d'un lieu)
amor, oris, m.	l'amour
amplectif, or, plexus sum (déponnent)	embrasser, entourer/traiter (un sujet)
amplus, a, um	vaste; important
an?	est-ce que... ou bien? (int. indir.: si... ou si)
an?	est-ce que vraiment? (réponse prévue: non)
an	ou, ou bien
anceps, cipitis	double; douteux; dangereux/à double face
ancilla, ae, f.	la servante
ancora, ae, f.	l'ancre
angulus, i, m.	l'angle; le coin
angustiae, arum, f. pl.	l'espace étroit, le défilé; la gêne, les difficultés
angustus, a, um	étroit/resserré
anima, ae, f.	le souffle vital, la vie; l'âme
animadvertere, o, ti, sum	remarquer; sévir (contre: in + acc.)/critiquer
animal, alis, n.	l'être vivant; l'animal
animus, i, m.	l'esprit; le coeur (sens fig.); le courage/l'âme (siège de la pensée)
mihi est in animo (+ inf.)	j'ai l'intention de
annalis, is, e	qui concerne une année
annon?	est-ce que... ou non?
annus, i, m.	l'année
annuus, a, um	annuel
ante	avant; (sens local) devant
ante + acc.	avant; devant
antea	auparavant
antecedere, o, cessi, cessum	précéder; l'emporter sur (+ acc.)
anteponere, o, posui, situm	placer devant; préférer
antequam + ind. ou subj.	avant que
antiquior (comparatif d'antiquus)	qqf., préférable
antiquissimus, a, um	qqf. préférable
antiquus, a, um	ancien (d'autrefois)
anulus, i, m.	l'anneau
anus, us, f.	la vieille femme
anxius, a, um	inquiet, angoissé; qui tourmente
aperire, io, perui, pertum	ouvrir; faire connaître
apertus, a, um	ouvert; qui se passe au grand jour, clair
apparatus, us, m.	la préparation; le matériel; le faste
apparere, eo, ui, itum	apparaître
apparet	il est manifeste que (+ prop. inf.)
appellare, o, rég.	appeler, nommer; adresser la parole à, faire appel à (+ acc.)
appellere, o, puli, pulsum	pousser vers, faire aborder (bateau); qqf., aborder
appetere, o, i(v)i, itum	désirer; rechercher; assaillir
apponere, o, posui, situm	placer auprès; servir (à table); ajouter
appropinquare, o, rég.	s'approcher (de: ad + acc.; dat.)/approcher
Aprilis, is, e	(d')avril
aptare, o, rég.	adapter; préparer
aptus, a, um	approprié (à: ad + acc.)/attaché
apud + acc.	chez; près de (sans changement de lieu)/devant (qqn)
aqua, ae, f.	l'eau
aquila, ae, f.	l'aigle (oiseau ou enseigne de légion)
ara, ae, f.	l'autel
arare, o, rég.	labourer
aratrum, i, n.	la charrue
arbiter, tri, m.	le témoin; l'arbitre/le juge; le maître
arbitrari, or, rég. (déponnent)	penser (que: + prop. inf.)/juger (comme arbitre)
arbitrium, ii, n.	le jugement, le bon plaisir/le libre pouvoir
arbor, oris, f.	l'arbre
arcere, eo, ui	écarter/maintenir dehors, repousser; maintenir dedans, retenir
arcessere, o, i(v)i, itum	faire venir
arcus, us, m.	l'arc
ardens, entis	brûlant
ardere, eo, arsi, arsum	être en feu, brûler
arduus, a, um	escarpé; difficile
area, ae, f.	l'espace plat et libre, la place, la cour; l'aire à blé
arena, ae, f.	le sable; l'arène
argenteus, a, um	d'argent
argentum, i, n.	l'argent (métal)
arguere, o, gui, gutum	prouver; accuser/montrer; dénoncer
argumentum, i, n.	la preuve; le sujet (la matière d'un texte)
argutus, a, um	fin, pénétrant; rusé; (poétique) aigu, sonore
aries, etis, m.	le bélier (animal ou machine de guerre)
arma, orum, n. pl.	les armes (surtout défensives)/les instruments
armare, o, rég.	armer; équiper
armentum, i, n.	le troupeau (de gros bétail)
arripere, io, ripui, reptum	saisir brusquement
ars, artis, f.	l'art; la technique; le métier/l'habileté; le procédé
artes, artium, f. pl.	les qualités (surtout morales)
artifex, ficis, m.	l'artisan; l'artiste
artificium, ii, n.	le métier; l'art/l'adresse; qqf. l'artifice
artus, a, um	étroit, resserré
artus, uum, m. pl.	les articulations (du corps), les membres
arvum, i, n.	la terre labourée/la campagne; la plaine
arx, arcis, f.	la citadelle
ascendere, o, di, sum	monter (intr.)/gravir
asinus, i, m.	l'âne
aspectus, us, m.	le regard/la vue; l'aspect
asper, era, erum	âpre; pénible/rugueux; dur
aspernari, or, rég. (déponnent)	repousser/rejeter
aspicere (adspicere), io, aspexi, aspectum	regarder/examiner; apercevoir
asportare, o, rég.	emporter
assequi, or, secutus sum (déponnent)	atteindre; obtenir
assidere (adsidere), eo, sedi, sessum	être assis auprès de, être installé auprès de (+ dat.); assister (qqn: + dat.)
assiduus, a, um	qui demeure en permanence; assidu/incessant
assuescere, o, suevi, suetum	s'habituer (à faire qqch.: + inf.)
assuevisse (parfait de assuescere)	avoir l'habitude
assuetus, a, um	habitué; habituel
assumere (adsumere), o, sumpsi, sumptum	prendre pour soi, s'approprier; prendre avec soi, s'adjoindre
astrum, i, n.	l'astre, l'étoile
at	mais, au contraire
ater, atra, atrum	noir; (poétique) funeste/sombre; (poétique) cruel
atque	et
atqui	et pourtant; eh bien alors (dans ces conditions)
atrium, ii, n.	l'atrium
atrocitas, atis, f.	l'horreur; la dureté, la cruauté
atrox, ocis	affreux; cruel/inflexible
attendere (adtendere), o, tendi, tentum	faire attention à (+ acc.)/diriger son esprit vers, remarquer
attingere (adtingere), o, tigi, tactum	toucher, atteindre
attollere (adtollere), o	élever, soulever; dresser
attonitus, a, um	frappé de stupeur; d'esprit égaré/en délire
attribuere, o, ui, utum	donner, attribuer
auctor, oris, m.	le garant; l'instigateur/le créateur; l'auteur d'un livre
auctoritas, atis, f.	l'influence (personnelle), l'autorité; l'instigation/la volonté, la décision
audacia, ae, f.	l'audace/la hardiesse
audax, acis	hardi, audacieux
audere, eo, ausus sum	oser
audire, io, i(v)i, itum	entendre; écouter; entendre dire (que: + prop. inf.)
auffere, fero, abstuli, ablatum	enlever; emporter/soustraire
augere, eo, auxi, auctum	augmenter (qqch.)
augur, uris, m.	l'augure
Augustus, a, um	(d')août
aura, ae, f.	le souffle, la brise
aureus, a, um	d'or, en or
auris, is, f.	l'oreille
aurum, i, n.	l'or
auspicium, ii, n.	l'auspice (présage)
aut	ou, ou bien
autem	or; quant à; mais
autumnus, i, m.	l'automne
auxilia, orum, n. pl.	les troupes auxiliaires
auxilium, ii, n.	le secours, l'aide
avaritia, ae, f.	la cupidité; (sens rare) l'avarice
avarus, a, um	cupide; (sens rare) avare
ave (have)!	bonjour! salut!
avertere, o, ti, sum	détourner
avidus, a, um	cupide, avide (de: + gén.)
avis, is, f.	l'oiseau
avunculus, i, m. (patruus, i, m.)	l'oncle (frère du père)
avus, i, m.	le grand-père
axis, is, m.	l'axe, l'essieu; (poétique) le char; l'axe du monde, le pôle; le ciel
