damnare, o, rég.	condamner (+ abl. ou gén. de la peine)
damnum, i, n.	le dommage, la perte
dapes, um, f. pl. (poétique)	le festin; les mets/le banquet sacré
dare, do, dedi, datum	donner
de + abl.	du haut de; au sujet de/de (éloignement ou origine); au cours de
dea, ae, f.	la déesse
debere, eo, ui, itum	devoir
decedere, o, cessi, cessum	s'en aller; (de vita) mourir
decedere (de vita)	mourir
decem	dix
December, bris, bre	(de) décembre
decernere, o, crevi, cretum	décider (de ou que: + inf. ou ut/ne + subj.)
decet, decuit	il est convenable, il convient (à qqn.: + acc.; de ou que: + inf.)
decimus, a, um	dixième
decipere, io, cepi, ceptum	tromper
declarare, o, rég.	faire connaître clairement; proclamer
decor, oris, m.	ce qui convient; l'ornement, la parure; le charme
decorus, a, um	qui convient; beau
decretum, i, n.	la décision; le décret
decurrere, o, curri, cursum	descendre en courant, se précipiter; aboutir à; parcourir
decus, oris, n.	la gloire, l'honneur/la parure
dedecus, oris, n.	le déshonneur, la honte
dedere, o, dedidi, deditum	livrer
se dedere	se rendre (à l'ennemi)
deditio, onis, f.	la capitulation, la soumission
deducere, o, duxi, ductum	faire descendre; emmener/escorter
deesse, sum, fui	manquer, faire défaut à (+ dat.)/ abandonner (+ dat.)
defectio, onis, f.	la défaillance: la disparition: la défection
defendere, o, di, sum	défendre (protéger)/repousser
defensio, onis, f.	la défense (protection); la plaidoirie
defensor, oris, m.	celui qui repousse; le défenseur
deferre, fero, tuli, latum	emporter; remettre (à qqn)/porter (de haut en bas); dénoncer
defessus, a, um	épuisé, fatigué
deficere, io, feci, fectum	faire défaut, manquer (à qqn: + acc.)/abandonner le parti de qqn (ab + abl.); s'éclipser (astre)
defigere, o, fixi, fixum	fixer, planter; figer
defungi, or, functus sum (déponnent)	s'acquitter de, exécuter (+ abl.)
vita defungi	mourir
dehinc	à partir d'ici, de là; à partir de ce moment, ensuite
dein	ensuite
deinde	ensuite
dejicere, io, jeci, jectum	jeter à bas/détourner
delectare, o, rég.	charmer/être agréable à, plaire à (+ acc.)
delectatio, onis, f.	le plaisir, l'agrément
delectus (dilectus), us, m.	le choix, la levée de troupes
delere, eo, evi, etum	détruire/effacer
delicatus, a, um	charmant; délicat
deliciae, arum, f. pl.	la volupté; les délices
delictum, i, n.	la faute, le délit
deligare, o, rég.	attacher
deligere, o, legi, lectum	choisir, enrôler
delubrum, i, n.	le sanctuaire, le temple
demens, entis	fou/fou furieux
demere, o, dempsi, demptum	ôter, enlever, retrancher
demissus, a, um	modeste; découragé/abaissé
demittere, o, misi, missum	faire descendre, laisser descendre
animum demittere	perdre courage
demonstrare, o, rég.	montrer, indiquer
demum	précisément; seulement
denarius, ii, m.	le denier
denique	enfin (pour clore une énumération)
dens, dentis, m.	la dent
densus, a, um	serré; épais
denuntiare, o, rég.	annoncer, déclarer/notifier
depellere, o, puli, pulsum	chasser, écarter, repousser
deponere, o, posui, situm	déposer; abandonner
deportare, o, rég.	transporter; rapporter
deprecari, or, rég. (déponnent)	chercher à détourner par des prières; demander de façon pressante
deprehendere, o, di, sum	prendre sur le fait/surprendre
descendere, o, di, sum	descendre
deserere, o, serui, sertum	abandonner
desertus, a, um	désert; inculte
desiderare, o, rég.	regretter l'absence de (+ acc.); qqf., désirer
desiderium, ii, n.	le regret; qqf., le désir/le besoin
designare, o, rég.	marquer, désigner; (poétique) dessiner
desilire, io, silui, sultum	sauter (du haut) de
desinere, o, desii, situm	cesser (de: + inf.)
desistere, o, stiti, stitum	cesser (de: + inf.); renoncer (à: + abl.)
desperare, o, rég.	désespérer
despicere, io, spexi, spectum	mépriser/regarder d'en haut
destinare, o, rég.	fixer; décider/destiner à
destituere, o, ui, utum	placer à l'écart; abandonner; supprimer; décevoir
deterior, ius (comparatif; superlatif deterrimus, a, um)	pire, plus mauvais; inférieur
deterrere, eo, ui, itum	détourner (de qqch.: ab + abl.; de faire qqch.: ne + subj.)
detinere, eo, tinui, tentum	tenir éloigné; retenir, arrêter; tenir occupé
detrahere, o, traxi, tractum	enlever; rabaisser
detrimentum, i, n.	le dommage, la perte
deus, i, m.	le dieu
dexter, t(e)ra, t(e)rum	placé à droite, droit
dextera (dextra), ae, f.	la main droite
dextre (dextera)	la main droite
dicare, o, rég.	vouer, consacrer
dicere, o, dixi, dictum	dire; plaider (pour qqn: pro + abl.)
dictum, i, n.	la parole, le mot
dies, diei, m. ou f.	le jour
differre, fero, distuli, dilatum	remettre à plus tard; être différent/disperser
difficilis, is, e	difficile
diffidere, o, fisus sum	se défier de (+ dat.)
diffundere, o, fudi, fusum	répandre, étendre
digitus, i, m.	le doigt
dignitas, atis, f.	le mérite; la dignité/le rang social
dignus, a, um	digne (de: + abl. ou qui + subj.)
digredi, ior, gressus sum (déponnent)	s'éloigner, s'écarter de
dilabi, or, lapsus sum (déponnent)	se disperser; se dissiper; tomber en ruines
dilectus (delectus), us, m.	le choix, la levée de troupes
diligens, entis	consciencieux, attentif
diligentia, ae, f.	le soin, l'application; le zèle/l'exactitude
diligere, o, lexi, lectum	aimer (par estime)
dimicare, o, rég.	combattre, lutter (contre qqn: cum + abl.)
dimittere, o, misi, missum	renvoyer; abandonner/envoyer de tous côtés
dirigere, o, rexi, rectum	aligner; régler; diriger
diripere, io, ripui, reptum	piller/déchirer
dirus, a, um	affreux; cruel/de mauvais augure
discedere, o, cessi, cessum	s'éloigner/se séparer
disceptare, o, rég.	juger, décider; débattre, discuter
discere, o, didici	apprendre (étudier)
discernere, o, crevi, cretum	séparer; distinguer (de: ab + abl.)
disciplina, ae, f.	l'enseignement
discipulus, i, m.	l'élève
discordia, ae, f.	la discorde
discrimen, minis, n.	la séparation; le moment décisif; le danger/la distinction
discutere, io, cussi, cussum	briser (en frappant); dissiper
dispergere, o, spersi, spersum	répandre/disperser
disponere, o, posui, positum	placer séparément; disposer; mettre en ordre, régler
disputare, o, rég.	discuter (une question)/faire une dissertation
dissentire, io, sensi, sensum	ne pas être d'accord (avec: génér. ab + abl.)
disserere, o, serui, sertum	enchaîner des idées, exposer avec méthode
dissimilis, is, e	différent (de: + gén. ou dat.)
distare, o	être éloigné, être différent (de: ab + abl.)
distinguere, o, stinxi, stinctum	différencier, distinguer
diu (comparatif diutius, superlatif diutissime)	longtemps
diu noctuque	de jour et de nuit
diuturnus, a, um	qui dure longtemps
diversus, a, um	qui va dans une direction contraire; opposé
dives, vitis	riche
dividere, o, visi, visum	partager; séparer/répartir
divinus, a, um	divin
divitiae, arum, f. pl.	les richesses
divus, a, um	divin
docere, eo, docui, doctum	enseigner (qqch. à qqn.: + double acc.)
doctrina, ae, f.	l'enseignement; la science
doctus, a, um	savant
dolere, eo, ui, itum	souffrir; s'affliger
dolor, oris, m.	la douleur; le chagrin
dolus, i, m.	la ruse
domare, o, mui, mitum	dompter
domesticus, a, um	de la maison; de la famille; de la patrie
domi	à la maison; à Rome
domi bellique	dans la paix et dans la guerre
dominari, or, rég. (déponnent)	être le maître; régner (sur: in + acc. ou abl.)
dominus, i, m.	le maître (de maison), le propriétaire/le seigneur, le souverain
domus, us, f.	la maison/la famille
donare, o, rég.	faire don de; gratifier (qqn de qqch.: aliquem aliqua re)
donec + ind.	tant que, aussi longtemps que; + ind. ou subj. : jusqu'à ce que
donum, i, n.	le don
dormire, io, i(v)i, itum	dormir
dubitare, o, rég.	se demander (+ int. indir.); hésiter à (+ inf.)
non dubitare quin (+ subj.)	ne pas douter que
dubius, a, um	douteux; indécis
ducere, o, duxi, ductum	conduire; estimer (que: + prop. inf.)/étirer, prolonger
dulcis, is, e	doux
dum + ind. présent	pendant que; en + part. présent
dum + ind.	tant que, aussi longtemps que; + ind. ou subj. : jusqu'à ce que
dum + subj.	pourvu que
dummodo + subj.	pourvu que
duo, duae, duo	deux
durare, o, rég.	endurcir; se durcir; durer/endurer
durus, a, um	dur; rude
dux, ducis, m.	le chef; le guide/le général
