ea	par là (par l'endroit en question)
eadem	par le même endroit
ebrius, a, um	ivre; rassasié
ebur, eboris, n.	l'ivoire
ecce	voici, voilà
ecqui, ecquae (ecqua), ecquod?	est-ce que quelque...?
ecquis, ecquid?	est-ce que quelqu'un (quelque chose)? y a-t-il quelqu'un (quelque chose) qui?
edere (esse), o, edi, esum	manger
edere, o, edidi, editum	faire sortir, produire; faire connaître, publier
edictum, i, n.	l'édit, l'ordonnance
educere, o, duxi, ductum	faire sortir
effere, fero, extuli, elatum	emporter/porter dehors; soulever; divulguer
efficere, io, feci, fectum	achever; faire en sorte que (ut/ne + subj.)
effigies, ei, f.	l'image, le portrait
effringere, o, fregi, fractum	ouvrir en brisant
effugere, io, fugi	s'enfuir; échapper à (+ acc.)
effundere, o, fudi, fusum	répandre au dehors; dissiper/déverser
egere, eo, ui	avoir besoin de, manquer de (+ abl. ou gén.); être dans le besoin
egestas, atis, f.	l'indigence, le dénuement
ego	moi
egredi, ior, gressus sum (déponnent)	sortir
egregius, a, um	excellent, remarquable
ejicere, io, jeci, jectum	faire sortir; jeter dehors/chasser
elabi, or, lapsus sum (déponnent)	s'échapper; disparaître
elegans, antis	(homme) de bon goût, distingué; délicat
eligere, o, elegi, electum	choisir, élire
emere, o, emi, emptum	acheter
eminere, eo, ui	s'élever au-dessus de/être en relief
eminus	de loin
emittere, o, misi, missum	faire sortir; émettre/lancer; laisser sortir, lâcher
enim	car, en effet, le fait est que
ensis, is, m.	l'épée
enuntiare, o, rég.	annoncer, déclarer/exposer; divulguer
eo	là (à l'endroit en question; avec changement de lieu)
eo... quo (+ comparatif)	d'autant (plus)... que... (plus)
eodem	au même endroit (avec changement de lieu)
epistula, ae, f.	la lettre (message)
epulae, arum, f. pl.	les mets; le repas/le banquet
eques, equitis, m.	le cavalier; le chevalier (classe sociale)
equester, tris, tre	de cavalerie; (de la classe) des chevaliers
equidem	quant à moi; assurément
equitatus, us, m.	la cavalerie
equus, i, m.	le cheval
erga + acc.	à l'égard de, envers
ergo	donc, en conséquence
erigere, o, rexi, rectum	dresser/rendre courage à (+ acc.)
eripere, io, ripui, reptum	arracher, enlever (à: + dat.)
errare, o, rég.	aller çà et là; se tromper
error, oris, m.	la course errante; l'incertitude; l'erreur
erubescere, o, bui	rougir; avoir honte
eruditus, a, um	instruit, cultivé
eruere, o, rui, rutum	déterrer, extraire; (poétique) détruire de fond en comble
erumpere, o, rupi, ruptum	se précipiter hors de/éclater
eruptio, onis, f.	la sortie brusque
erus (herus), i, m.	le maître, le propriétaire
esse, sum, fui, futurus	être; appartenir à (+ dat.); être le propre de, être le devoir de (+ gén.)/exister
et	même, aussi
et	et
et...et	d'une part... d'autre part
etenim	car, en effet, le fait est que
etiam	même, aussi, encore/oui
etiamsi + ind. ou subj.	même si
etsi + ind.	quoique, bien que
evadere, o, vasi, vasum	s'échapper/sortir de; finir par devenir
evenire, io, veni, ventum	arriver, avoir lieu
evenit, venit	il arrive que (ut/ut non + subj.)
eventus, us, m.	l'événement; le résultat/le dénouement
evertere, o, ti, sum	détruire de fond en comble
evocare, o, rég.	appeler à soi, faire venir
ex (e) + abl.	de (éloignement ou origine), hors de; par suite de, d'après; depuis
exagitare, o, rég.	harceler, traquer
excedere, o, cessi, cessum	sortir
excellens, entis	éminent
excellere, o	être supérieur
excelsus, a, um	élevé
excidere, o, cidi	tomber de; sortir de, échoir; se perdre; être dépossédé de (+ abl.)
excipere, io, cepi, ceptum	excepter; recueillir/mettre à part
excitare, o, rég.	exciter/provoquer; faire lever (qqn)
excludere, o, clusi, clusum	faire sortir, exclure/repousser, empêcher
excogitare, o, rég.	imaginer, inventer
excutere, io, cussi, cussum	arracher/faire tomber en secouant
exemplum, i, n.	l'exemple
exercere, eo, ui, itum	exercer; former/tenir en haleine
exercitatio, onis, f.	l'exercice
exercitus, us, m.	l'armée
exhaurire, io, hausi, haustum	épuiser/enlever
exigere, o, egi, actum	faire sortir; achever; exiger
exiguus, a, um	petit, exigu
eximere, o, emi, emptum	enlever, ôter
eximius, a, um	excellent, remarquable
exire, eo, ii, itum	sortir
existimare, o, rég.	juger, estimer (que: + prop. inf.)
existimatio, onis, f.	l'opinion; la réputation
exitium, ii, n.	la destruction, la perte, la ruine
exitus, us, m.	la sortie; la fin
exorare, o, rég.	chercher à obtenir par des prières; obtenir par des prières; fléchir (qqn)
expedire, io, i(v)i, itum	débrouiller; apprêter/dégager
expedit, i(v)it	il est avantageux
expeditus, a, um	légérement équipé; en tenue de combat
expellere, o, puli, pulsum	chasser (qqn d'un lieu), bannir
experiri, ior, pertus sum (déponnent)	expérimenter; tenter (de: ut + subj.)/éprouver
expers, pertis	dépourvu de (+ gén.); ne participant pas à (+ gén.)
expetere, o, i(v)i, itum	convoiter; réclamer
explere, eo, evi, etum	remplir/combler; rassasier
explicare, o, rég. (ou plicui, plicitum)	déployer; débrouiller/développer
explorare, o, rég.	examiner, reconnaître (un terrain, etc.); mettre à l'épreuve, s'assurer de (+ acc.)
explorator, oris, m.	l'éclaireur (militaire), l'espion
exponere, o, posui, situm	exposer; débarquer (qqn ou qqch.)
exprimere, o, pressi, pressum	faire sortir de, extraire; exprimer
exprobrare, o, rég.	reprocher; censurer
expugnare, o, rég.	prendre d'assaut
exsequi, or, secutus sum (déponnent)	accomplir, exécuter/suivre jusqu'au bout
exsilium (exilium), ii, n.	l'exil
exsistere (existere), o, stiti	s'élever; naître/se manifester
exspectare (expectare), o, rég.	attendre
exspectatio, onis, f.	l'attente; l'espérance; l'impatience
exstinguere (extinguere), o, stinxi, stinctum	éteindre; détruire/faire disparaître
exstruere, o, struxi, structum	bâtir, élever
exsul (exul), ulis, m. et f. (ou adj.)	l'exilé, l'exilée/le proscrit
exsultare (exultare), o, rég.	bondir; être transporté de (joie, etc.: + abl.)
extemplo	sur-le-champ, aussitôt
extendere, o, di, sum (tum)	étendre, allonger, élargir
externus (exterus), a, um	du dehors; étranger
extollere, o, extulli	élever, relever; exalter; honorer
extra	au-dehors
extra + acc.	en dehors de
extremus, a, um (superlatif)	le plus à l'extérieur; extrême, dernier
exuere, o, ui, utum	débarrasser de (+ abl.); se débarrasser de (+ acc.)/dépouiller de
exuviae, arum f. pl.	la dépouille, la peau (d'une bête); les dépouilles (le butin)
