egere, eo, ui	avoir besoin de, manquer de (+ abl. ou gén.); être dans le besoin
haurire, io, hausi, haustum	puiser; engloutir/vider
humilis, is, e	bas; humble
humor (umor), oris, m.	le liquide (surtout l'eau)
inopia, ae, f.	le manque (de qqch.), le dénuement
libertus, i, m.	l'affranchi
licentia, ae, f.	la liberté (de faire qqch.), la permission; la licence
luxuria, ae, f.	le luxe/la profusion
miser, sera, serum	malheureux
neglegere, o, lexi, lectum	négliger
nocere, eo, ui, itum	nuire (à: + dat.)
paratus, a, um	préparé; prêt (à: ad+ acc.)
potior, ius (comparatif)	préférable
praeferre, fero, tuli, latum	présenter; préférer/porter devant
prodesse, prosum, profui	être utile (à: + dat.)
seditio, onis, f.	la dissenssion; la révolte
servire, io, i(v)i, itum	être esclave de; être au service de (+ dat.)
servus, i, m.	l'esclave
spectaculum, i, n.	le spectacle
torquere, eo, torsi, tortum	tordre; brandir; torturer/faire tourner
tumultus, us, m.	le désordre; le vacarme/le trouble; la levée en masse (lors d'une guerre soudaine)
vilis, is, e	(qui est) bon marché; sans valeur, vil