eques, equitis, m.	le cavalier; le chevalier (classe sociale)
equitatus, us, m.	la cavalerie
equus, i, m.	le cheval
gloria, ae, f.	la gloire
miles, itis, m.	le soldat
militia, ae, f.	le service militaire/la campagne (guerre)
ordo, dinis, m.	le rang, l'ordre; la classe/la succession
parcere, o, peperci, parsum	épargner, ménager (+ dat.)/s'abstenir de (+ dat. ou abl.)
pedes, itis, m.	le fantassin
praeda, ae, f.	le butin; la proie
praestare, o, stiti, statum (stitum)	l'emporter sur (+ dat.); faire preuve de (+ acc.); fournir
res gestae, rerum gestarum, f. pl.	les exploits; l'histoire
subigere, o, egi, actum	soumettre; retourner le sol/contraindre
superare, o, rég.	franchir; vaincre/surpasser; être de reste, rester; être en surabondance
triumphus, i, m.	le triomphe
triumphum agere	obtenir	les honneurs du triomphe
victor, oris, m.	le vainqueur
victoria, ae, f.	la victoire
vincere, o, vici, victum	vaincre
vindicare, o, rég.	punir; venger/revendiquer; délivrer (de: ab + abl.)