faber, bri, m.	l'ouvrier (sur bois ou sur métal), l'artisan
fabula, ae, f.	le conte, la fable; la pièce de théâtre
facere, io, feci, factum	faire (passif: voir fieri)
facere magni/magni facere	estimer beaucoup même construction pour habere, ducere, etc.)
facere non possum quin + subj.	je ne puis m'empêcher de
iter facere	(per + acc.) faire route, passer par
facies, ei, f.	l'aspect; la figure/la forme
facile	facilement
facilis, is, e	facile/affable
facinus, oris, n.	l'action d'éclat; le crime
factio, onis, f.	le parti (politique); la faction
factum, i, n.	le fait; l'acte; l'action
facultas, atis, f.	la possibilité (de faire qqch.)/le talent
facultates, um, f. pl.	les ressources
fallax, acis	trompeur
fallere, o, fefelli, falsum	tromper; échapper à (+ acc.); passif falli: se tromper
falli (passif)	se tromper
falsus, a, um	faux
fama, ae, f.	la rumeur publique, la nouvelle; la réputation
fames, is, f.	la faim; la famine
familia, ae, f.	la maisonnée; la famille; le personnel de maison
familiaris, is, e	qui appartient à la famille; qui fait partie du personnel
familiaris, is, m.	l'ami intime, le familier
famulus, i, m.	le serviteur/le domestique
fanum, i, n.	le temple
fari, fatur, fatus sum (déponnent)	parler
fas est	il est permis (par les dieux)
fascis, is, m.	le faisceau
fasti, orum, m. pl.	les fastes
fastidium, ii, n.	le dégoût
fastigium, ii, n.	le sommet, le faîte/la pente
fastus, a, um	(jour) faste (où il est permis de rendre la justice)
fateri, eor, fassus sum (déponnent)	avouer
fatigare, o, rég.	fatiguer, épuiser; obséder
fatum, i, n.	le destin; la mort/le malheur, l'heure fatale
fauces, ium, f. pl.	la gorge; le défilé/le gosier
faustus, a, um	heureux (événement), favorable; prospère
favere, eo, favi, fautum	favoriser (+ dat.)
fax, facis, f.	la torche
Februarius, a, um	(de) février
felix, icis	heureux (qui a de la chance)/favorable; fécond
femina, ae, f.	la femme; la femelle
fera, ae, f.	la bête sauvage
fere	presque, à peu près; généralement
ferire, io	frapper
ferme (superlatif de fere)	presque, à peu près; généralement
ferox, ocis	fougueux; fier/hardi
ferre, fero, tuli, latum	porter; supporter; rapporter que (+ prop. inf.)/comporter
ferreus, a, um	de fer, en fer
ferrum, i, n.	le fer; l'objet en fer
ferus, a, um	sauvage; cruel/farouche
fervere, eo, fervi (ferbui)	bouillonner, être agité
fessus, a, um	fatigué
festinare, o, rég.	se hâter (de: + inf.); hâter
festus, a, um	de fête
fidelis, is, e	à qui on peut se fier; fidèle/loyal
fidere, o, fisus sum	se fier à, compter sur (+ dat. ou abl.)
fides, ei, f.	la confiance; la loyauté; la protection/la parole donnée; le crédit
fiducia, ae, f.	la confiance, l'assurance/la hardiesse
fidus, a, um	à qui (à quoi) on peut se fier, sûr
fieri, fio, factus sum	être fait (fieri sert de passif à facere); devenir
fit, factum est	il arrive que (ut, ut/non + subj.)
figere, o, fixi, fixum	fixer; transpercer/ficher, enfoncer
figura, ae, f.	la forme; la figure
filia, ae, f.	la fille
filiola, ae, f.	la fille en bas âge: la fille chérie
filius, ii, m.	le fils
fines, ium, m. (pl. de finis)	les frontières; le territoire/le pays
fingere, o, finxi, fictum	façonner; imaginer
finire, io, i(v)i, itum	limiter; terminer/déterminer
finis, is, m.	la limite; la fin (voir fines)
finitimus, a, um	voisin
firmare, o, rég.	fortifier/confirmer
firmus, a, um	solide, résistant
flagitare, o, rég.	demander instamment, réclamer
flagitium, ii, n.	le scandale; l'infamie
flagrare, o, rég.	brûler (être en feu)
flamen, minis, n.	le flamine
flamma, ae, f.	la flamme
flectere, o, flexi, flexum	fléchir (qqch.)/ployer; faire tourner; se tourner
flere, eo, flevi, fletum	pleurer
fletus, us, m. sg.	les pleurs
florere, eo, ui	être en fleur; être florissant
flos, floris, m.	la fleur/l'élite
fluctus, us, m.	la vague, le flot/l'agitation
fluere, o, xi, fluxum	couler
flumen, minis, n.	le fleuve, la rivière
focus, i, m.	le foyer
fodere, io, fodi, fossum	creuser/dégager en fouillant; percer
foedus, a, um	hideux; honteux/repoussant
foedus, eris, n.	le traité
folium, ii, n.	la feuille
fons, fontis, m.	la source; la fontaine/l'origine, le principe
foramen, minis, n.	le trou, l'ouverture
foras	dehors (avec changement de lieu)
forensis, is, e	de la place publique; judiciaire
fores, ium, f. pl.	la porte (dans une maison)
foris	dehors (sans changement de lieu)
forma, ae, f.	la forme; la beauté/le type
formido, dinis, f.	l'effroi, l'épouvante
formidolosus, a, um	effrayant; qqf. peureux
formosus, a, um	beau
forsitan	peut-être
fortasse	peut-être
forte	par hasard
fortis, is, e	courageux/vigoureux
fortiter	courageusement
fortuitus, a, um	dû au hasard, accidentel
fortuna, ae, f.	le sort, la chance; la destinée
fortunae, arum, f. pl.	la fortune (les biens)
fortunatus, a, um	favorisé par le sort, heureux; opulent
forum, i, n.	la place publique, le forum/les affaires; la vie politique; le tribunal
fossa, ae, f.	le fossé
fovere, eo, fovi, fotum	réchauffer; choyer; encourager/soutenir
fragor, oris, m.	le bruit éclatant, le fracas
frangere, o, fregi, fractum	briser/abattre
frater, tris, m.	le frère
fraus, fraudis, f.	la fourberie; le crime/le dommage
fremere, o, ui, itum	faire entendre un grondement; dire en frémissant ou en grondant
frequens, entis	en nombre (personnes); fréquenté (lieu)/répété, fréquent (sens plus rare)
fretum, i, n.	le détroit; (poétique) la mer
frigidus, a, um	froid
frigus, oris, n.	le froid
frons, frondis, f.	le feuillage, la frondaison
frons, frontis, f.	le front
fructus, us, m.	le fruit; la jouissance (de qqch.)/le revenu
fruges, um, f. pl.	les produits de la terre; les moissons/les céréales
frui, or, fructus sum (déponnent)	jouir, profiter (de: + abl.)
frumentum, i, n.	le blé
frustra	en vain
fuga, ae, f.	la fuite
fugare, o, rég.	mettre en fuite
fugere, io, fugi	fuir, échapper
fugitivus, i, m.	l'esclave fugitif
fulgere, eo, fulsi	faire des éclairs; briller
fulgur, uris, n.	la foudre; l'éclat
fulmen, minis, n.	la foudre
fundere, o, fudi, fusum	verser, répandre; mettre en déroute
funditus (adv.)	de fond en comble
fundus, i, m.	le fond; le fonds de terre, le domaine
fungi, or, functus sum (déponnent)	s'acquitter de (+ abl.)/accomplir (qqf. + acc.)
funis, is, m.	la corde, le câble
funus, eris, n.	les funérailles; la mort/la ruine; (poétique) le cadavre
furari, or, rég. (déponnent)	voler, dérober
furere, o	être hors de soi; être en délire/être en furie
furiosus, a, um	dément; en délire
furor, oris, m.	la folie (violente)
furtum, i, n.	le vol (délit)
