ibi	là (à l'endroit en question; sans changement de lieu)
ibidem	au même endroit (sans changement de lieu)
icere, o (io), ici, ictum	frapper, blesser
ictus, us, m.	le coup
id est	c'est-à-dire
idem, eadem, idem	le même (que: ac/atque ou qui)
ideo	pour cette raison
idoneus, a, um	qui convient pour, capable de (+ dat. ou ad + acc.)
idus, uum, f. pl.	les ides
igitur	donc, en conséquence
ignarus, a, um	ignorant (de: + gén.)
ignavus, a, um	inactif; lâche
ignis, is, m.	le feu
ignobilis, is, e	inconnu; de basse naissance
ignominia, ae, f.	le déshonneur, la honte
ignorare, o, rég.	ignorer
ignoscere, o, novi, notum	pardonner (à: + dat.)
ignotus, a, um	inconnu
illac	par là-bas (où il est)
ille, illa, illud	ce (cet), celui-là (qui le concerne); celui-là (qui est éloigné); cet (homme, etc.) illustre
illecebra, ae, f.	la séduction, l'attrait
illic	là-bas (où il est; sans changement de lieu)
illinc	de là-bas (où il est)
illo/illuc	là-bas (où il est; avec changement de lieu)
illustrare, o, rég.	éclairer; rendre brillant
illustris, is, e	illustre/lumineux
imagines, um, f. pl.	les bustes (en cire) des ancêtres
imago, ginis, f.	le portrait; l'image
imbecillus, a, um	faible
imber, bris, m.	la pluie
imitari, or, rég. (déponnent)	imiter
immanis, is, e	cruel; monstrueux/barbare; énorme
immensus, a, um	sans limites, immense
imminere, eo	être tout proche; menacer (+ dat.)/être suspendu au-dessus de
imminuere, o, ui, utum	réduire, affaiblir; ruiner
immittere, o, misi, missum	laisser aller; jeter contre/lancer dans ou sur (in + acc.)
immo	au contraire
immo vero	au contraire; bien plus
impar, paris	inégal, inférieur; inéquitable; impair
impedimenta, orum, n. (pl. d''impedimentum)	les bagages (d'une armée)/le train
impedimentum, i, n.	l'empêchement
impedire, io, i(v)i, itum	gêner; empêcher (de ou que: ne, quin ou quominus + subj.)
impeditus, a, um	chargé de bagages, embarrassé
impellere, o, puli, pulsum	pousser à
impendere, eo	être suspendu sur; menacer (+ dat.)
impendere, o, di, sum	dépenser
imperare, o, rég.	commander à (+ dat.); commander de ou que (ut/ne + subj.)
imperator, oris, m.	le général en chef/ le général victorieux; (sens post.) l'empereur
imperitus, a, um	inexpérimenté, ignorant (+ gén.)
imperium, ii, n.	le commandement; le pouvoir; l'empire/la domination
impertire, io, i(v)i, itum	donner une part de (+ acc.); consacrer à (+ dat.)
impertiri (déponnent)	donner une part de (+ acc.); consacrer à (+ dat.)
impetrare, o, rég.	obtenir (qqch. de qqn: aliquid ab aliquo); obtenir que (ut/ne + subj.)
impetus, us, m.	l'élan; l'assaut
impiger, gra, grum	actif, infatigable
implere, eo, evi, etum	remplir/saturer
implicare, o, rég. (ou plicui, plicitum)	emmêler; envelopper; engager dans (+ abl.)
imponere, o, posui, situm	mettre sur; imposer à; embarquer (qqn ou qqch.)
importunus, a, um	incommode; fâcheux; intraitable
impotens, entis	impuissant, faible; qui n'est pas maître de (+ gén.); immodéré, effréné, emporté
imprimis (in primis)	surtout/avant
improbus, a, um	malhonnête; mauvais/démesuré; sans répit
improvisus, a, um	imprévu
imprudens, entis	ignorant (+ gén.); qui agit sans faire attention, surpris
impudens, entis	effronté, impudent
impune	impunément; sans danger
imus, a, um	le plus bas
imus mons	le pied de la montagne
in + acc.	en, dans, sur (avec changement de lieu); pour (but); envers, contre
in + abl.	en, dans, sur (sans changement de lieu)/quand il s'agit de (génér. avec le gérondif)
inanis, is, e	vide, vain
incedere, o, cessi, cessum	s'avancer
incendere, o, di, sum	enflammer/exciter
incendium, ii, n.	l'incendie
inceptum, i, n.	l'entreprise
incertus, a, um	incertain
incidere, o, cidi	tomber dans, tomber sur; arriver
incidere, o, cidi, cisum	graver; trancher/entailler
incipere, io, cepi, ceptum	commencer, entreprendre
incitare, o, rég.	exciter/donner de l'élan, animer; stimuler
includere, o, clusi, clusum	enfermer
incola, ae, m.	l'habitant
incolere, o, ui	habiter
incolumis, is, e	sain et sauf, intact
incommodum, i, n.	le dommage; l'inconvénient
incredibilis, is, e	incroyable; inouï
increpare, o, pui, pitum (ou rég.)	faire du bruit; faire retentir; invectiver; dire avec des reproches (que: + prop. inf.)
incultus, a, um	inculte; négligé; sauvage
incumbere, o, cubui, cubitum	se coucher sur/s'appuyer sur; s'appliquer à
inde	de là (de l'endroit en question)
inde	ensuite
index, icis, m. et f.	le dénonciateur, la dénonciatrice
indicare, o, rég.	dénoncer
indicere, o, dixi, dictum	déclarer officiellement; notifier, prescrire
indicium, ii, n.	la dénonciation; la preuve/l'indice
indidem	du même endroit
indigere, eo, ui	avoir besoin de, manquer de (+ abl. ou gén.); être dans le besoin
indignari, or, rég. (déponnent)	s'indigner
indignus, a, um	indigne (de: + abl. ou qui + subj.)
indoles, is, f.	le caractère; le naturel
inducere, o, duxi, ductum	introduire; amener (à faire qqch.)/appliquer sur
induere, o, ui, utum	revêtir, mettre (un vêtement)
indulgere, eo, dulsi, dultum	être bienveillant pour (+ dat.); s'abandonner à (+ dat.)
industria, ae, f.	l'activité
(abl.) industria (qqf. avec de ou ex)	à dessein, exprès
indutiae, arum, f. pl.	la trêve, l'armistice
inermis, is, e	non armé; sans défense
iners, ertis	inhabile; inactif
inertia, ae, f.	l'incapacité, l'inaction
inesse, sum, fui	être dans ou sur; appartenir à
infamis, is, e	de mauvaise réputation, déshonorant
infandus, a, um	dont on ne doit pas parler; abominable, monstrueux
infans, antis	incapable de parler
infans, antis, m. et f.	le (la) jeune enfant
infelix, icis	malheureux (qui n'a pas eu de chance); funeste; improductif, stérile
infensus, a, um	hostile à; irrité contre
inferus, a, um (comparatif inferior; superlatif infimus)	qui est au-dessous, inférieur
inferre, fero, intuli, illatum	porter dans, porter contre
infestus, a, um	hostile (à: + dat.); exposé aux attaques (lieu)/acharné contre; infesté (lieu)
infra	plus bas
infra + acc.	au-dessous de
ingenium, ii, n.	l'intelligence; le talent; le caractère/les dispositions naturelles; le génie
ingens, entis	énorme, immense
ingenuus, a, um	né de parents libres, de bonne famille; digne d'un homme libre, de bon ton; né dans le pays, naturel
ingratus, a, um	désagréable, ingrat; reçu sans reconnaissance
ingravescere, o	s'alourdir; croître; s'aggraver
ingredi, ior, gressus sum (déponnent)	entrer
inhibere, eo, ui, itum	retenir, arrêter; appliquer à
inimicus, a, um	ennemi
inimicus, i, m.	l'ennemi (personnel)
iniquus, a, um	défavorable; injuste/inégal; qui manque de calme; excessif
inire, eo, ii, itum	entrer dans; entreprendre
initium, ii, n.	le commencement
injicere, io, jeci, jectum	jeter dans, jeter sur
injungere, o, junxi, junctum	relier à; appliquer sur; imposer
injuria, ae, f.	l'injustice; le dommage
injuria	à tort
injussu	sans l'ordre de (+ gén.)
innocens, entis	qui ne fait pas de mal; innocent/irréprochable
inopia, ae, f.	le manque (de qqch.), le dénuement
inops, opis	dépourvu de (+ gén.)/ pauvre
inquirere, o, quisivi, situm	chercher à découvrir, enquêter
inquit, inquam, inquiunt	dit-il, dis-je...
insanire, io, i(v)i, itum	être fou; avoir perdu le bon sens
insanus, a, um	fou, insensé; qui rend fou; extravagant, excessif
insequi, or, secutus sum (déponnent)	poursuivre/harceler; suivre, continuer
inserere, o, serui, sertum	introduire, insérer; mêler
insidiae, arum, f. pl.	l'embuscade, le guet-apens
insigne, is, n.	la marque distinctive, l'insigne; la parure
insignis, is, e	remarquable
insistere, o, stiti	se placer sur, fouler; s'attacher à, s'arrêter
insolens, entis	qui n'a pas l'habitude (de: + gén.); insolite; excessif; arrogant
insons, sontis	innocent; (poétique) inoffensif
instare, o, stiti	se tenir sur; insister; menacer (+ dat.)/ être imminent; presser vivement
instituere, o, ui, utum	organiser, instituer; entreprendre/former (instruire)
instituta, orum, n. pl.	les institutions/les préceptes philosophiques
insitutum, i, n.	l'usage établi/la règle; l'organisation
instruere, o, struxi, structum	disposer; équiper/préparer
instrumentum, i, n.	l'équipement, le matériel, l'outillage
insula, ae, f.	l'île
integer, gra, grum	intact, entier; intègre
intellegere, o, lexi, lectum	comprendre (que: + prop. inf.)
intendere, o, tendi, tentum	tendre; diriger vers/raidir; se diriger vers
intentus, a, um	tendu; attentif, appliqué à
inter + acc.	parmi, entre; dans l'espace de (temps)
intercedere, o, cessi, cessum	se placer entre; intervenir contre, opposer son veto à (+ dat.)
intercessio, onis, f.	l'intervention, l'opposition
intercipere, io, cepi, ceptum	intercepter; enlever, dérober; barrer
interdicere, o, dixi, dictum	interdire (de: ne + subj.)
interdum	parfois
interea	pendant ce temps
interesse, sum, fui	être différent; être dans l'intervalle; participer à (+ dat.)
interest, fuit	il importe (à qqn: + gén.; à qqch.: ad + acc.)
mea interest	il m'importe
interficere, io, feci, fectum	tuer
interim	pendant ce temps/parfois
interimere, o, emi, emptum	tuer
interire, eo, ii, itum	disparaître; périr
interitus, us, m.	l'anéantissement, la mort
intermittere, o, misi, missum	laisser dans l'intervalle; interrompre
interpres, etis, m. et f.	l'intermédiaire; l'interprète
interrogare, o, rég.	interroger, questionner
intervallum, i, n.	l'intervalle (temps ou lieu)
intra + acc.	au-dedans de; en moins de
intrare, o, rég.	entrer
intueri, eor, tuitus sum (déponnent)	regarder attentivement
intus	au-dedans, à l'intérieur; de l'intérieur
inultus, a, um	non vengé; impuni; sans dommage
invadere, o, vasi, vasum	envahir; assaillir/ entrer dans; (poétique) entreprendre; apostropher
invehi, or, vectus sum (verbe passif)	aller, entrer dans; attaquer (in + acc.)
invenire, io, veni, ventum	trouver/découvrir, inventer
invicem	tour à tour; mutuellement
invictus, a, um	invaincu; invincible
invidere, eo, vidi, visum	envier (+ dat.)
invidia, ae, f.	la jalousie, l'envie; la haine/la malveillance
invidus, a, um	envieux, jaloux
invisus, a, um	haï de, odieux à (+ dat.)
invitare, o, rég.	inviter
invitus, a, um	qui agit malgré soi, à contre-coeur
ipse, ipsa, ipsum	lui en personne, lui-même; lui de son côté
ira, ae, f.	la colère
iracundia, ae, f.	le penchant à la colère; le mouvement de colère
irasci, or, iratus sum (déponnent)	se mettre en colère
iratus, a, um	en colère, irrité (contre: + dat.)
ire, eo, i(v)i, itum	aller, marcher
irridere, eo, risi, risum	se moquer (de: + acc.)
irritus, a, um	vain, sans effet
irrumpere, o, rupi, ruptum	se précipiter dans ou sur (in + acc.)
is, ea, id (génitif ejus - eorum)	le... en question; celui-ci, ce (cet); le... (qui...); (par emprunt) il
ejus - eorum (génitif de is, ea, id)	son - leur
is...qui + ind.	le... qui
is...qui + subj.	tel... que (idée de conséquence)/capable de
is... ut (ou qui) + subj.	tel... que (idée de conséquence)/capable de
istac	par là (où tu es)
iste, ista, istud	ce (cet), celui-là (qui te concerne); cet individu-là (en politique ou en justice)
istic	là (où tu es; sans changement de lieu)
istinc	de là (où tu es)
istuc	là (où tu es; avec changement de lieu)
ita	ainsi, de telle façon/oui
ita... ut	(+subj.) de sorte que, si bien que
itaque	c'est pourquoi/aussi (+ inversion)
item	de même
iter, itineris, n.	le voyage; le chemin; l'étape/la marche
iterum	de nouveau, une seconde fois
