fere	presque, à peu près; généralement
potius quam + ind.	plutôt que; + subj. : plutôt que de
qui(s), quae, quid ?	qui? quoi? (qqf. exclamatif)
qui(s), quae, quod ?	lequel? quel? (qqf. exclamatif)
qui(s), quae, quod !	lequel! quel! (qqf. exclamatif)
-ne ?	est-ce que?
nonne ?	est-ce que... ne... pas? n'est-il pas vrai que? (réponse prévue: oui)
num?	est-ce que par hasard? (réponse prévue: non)/ [dans une interrogative indirecte, num ou ne- traduitent par : si (d'interrogation)]
cur?	pourquoi?
quomodo?	comment?
ubi	où, là où (sans changement de lieu)
ubi?	où? (sans changement de lieu)
quo?	où (avec changement de lieu)
unde?	d'où
unde	d'où
qua?	par où?
qua	par où
fortasse	peut-être
-ve	ou, ou bien
sive (seu)... sive (seu)	soit... soit
sive (seu)... sive (seu) + ind.	soit que... soit que
an?	est-ce que... ou bien? (int. indir.: si... ou si)
an?	est-ce que vraiment? (réponse prévue: non)
an	ou, ou bien
utrum (-ne)...an?	est-ce que... ou bien? (int. indir.: si... ou si)
quare?	pourquoi?
quando?	quand?
qualis, is, e? ou qualis!	quel? (=de quelle qualité?); quel!
quantus, a, um? ou quantus!	quel? (=de quelle grandeur?); quel!
quantum? ou quantum!	combien? combien!
quam? ou quam!	combien? combien! (avec idée d'intensité)