propter + acc.	à cause de/à côté de
igitur	donc, en conséquence
ergo	donc, en conséquence
itaque	c'est pourquoi/aussi (+ inversion)
quare	c'est pourquoi/aussi (+ inversion)
vero (premier mot de la phrase)	vraiment, en réalité
vero	quant à; mais
quidem	assurément, certes; du moins
haud	ne... pas, non
et (adverbe)	même, aussi
quin	et même
quin etiam	et même
quamquam (quanquam)	d'ailleurs; et pourtant
immo	au contraire
immo vero	au contraire; bien plus
vere	avec vérité, de manière juste, conformément à la vérité
profecto	assurément
certe	en tout cas; du moins/certainement
ne !	(+subj.) ne... pas! (défense)
neve +sub. (neu)	et que... ne... pas, et de ne pas; et afin que... ne... pas